# ? # # # # # # # # # # # # # # # # # #
# ? ? ? ? ? ? ? ? ? ? ? ? ? ? ? - - # #
# # # # # - # # - # # - # # # ? # - - #
# - # # # - # - - # # - # # - ? # - # #
# - # - - - # # # # # # # # # ? # - - #
# - - - # - - - - # - # # - # ? # # # #
# - # # # # - # - - - - - - - ? ? ? - #
# - # # - - - # # # # # # # # # # ? # #
# - - - - # - - # # - - - - - - - ? ? #
# # # # # # # # # # # # # # # # # # ? #
